WWWWWW
W1 , K E
W WW WWW
W W  + K E
W WWWW WWWWWWWWWWWWWWWWWWWWWWWWWWWWWWWW
W W   - ----- ----- ----- ----- ----- K E
W WWWWWWWWWWWWWWWWWWWWWWWWWWWWWWWWWWW W
W   . + +++++ +++++ +++++ +++++ +++++ W
WWWWWWWWWWWWWWWWWWWWWWWWWWWWWWWWWWWWWWW

this program stops at any of EOF, 0 and 26
